ooooooooooooo
oXXXXXoXXXXXo
oXoooXoXoooXo
oXoXXXoXXXoXo
oXoXoooooXoXo
oXoXoXXXoXoXo
oooXoXXXoXooo
oXoXoXXXoXoXo
oXoXoooooXoXo
oXoXXXoXXXoXo
oXoooXoXoooXo
oXXXXXoXXXXXo
ooooooooooooo
